--#---#-
#-------
---#----
--#-#---
-----#--