--#--#---
#---#----
---#--#--
--#-#--#-
-----#---
#--#---#-
---#----
-#-------
----#--#-
