--#--#--
#-------
---#--#-
--#-#---
#----#--
#--#----
---#----