---#----------
------#------#
#-------------
-----#-------#
---#---------#
--------#----#
------#------#
#-------------
-----#-------#
-#------#----#
----#-----#--#

