---#----#--
------#----
#----------
-----#-----
---#-------
--------#--
------#----
#----#-----
-----#-----
----#---#--
----#------
-------#---
