----#-----
--#-------
------#---
#-----###-
-----#--#-
-#-#----#-
------#---
----#-----
#-------#-
##----#--#
