-#--#---#--
--#---#-----
#---#-----#-
--#--#----#-
#--#------#-
#----#--#--#
#-#---#----#
#------#####
#----#------
#-#-----#---
