----#----#---
--#---#------
-----#--#----
#-------#----
------#--##--
----#-----#--
-------#--#--
------#---#--
#--#------#--
--#----#-----
---#---------
#-------#----
-----#-------
#-----#------
