----#----------
--#------------
--------#-----#
#--------------
------#----####
----#--#-------
----------#---#
------#-----#-#
#-----------#--
-------#------#
---#---------#-
--------#----##
-----#-------#-
------#-------#
--#------#---##
