--#--#--#--
-##----#---
#--#---#--#
-----#----#
---#------#
----#---#--
---#--#----
#--#-------
-#---#-----
---#----#--
