--#--#---
#--##----
---#--#--
--#-#----
-#---#--#