--#--#--
########
---#----
--#-#---
-----#--
#--#----
---#----
-#-------
