-------#-----------#####------
-------------#----------------
----#--------#----------------
---------#--------------------
--------------#------##-------
---------------#--------------
----------#----#--------------
----------#-------------------
#-----------------####-------
----------#----------#--------
-------------#---------------
----------#-------------------
------#--------------##-------
----------#---------#---------
---------------#--------#-----
------------------#-----------
------------#-----------------
---------------------#--------
------------------#-----------
---------#--------------------
