#-#-#--------###
---#-#---#------
--#--#--#---#---
--#-------------
-----#------#---
--#---#---------
----#--#----#---
#----#------#---
-----#---#------
--#---------#---
----#----####---
-----#------#---
-----##-#---#---
###--#--#--##---
