------#---------------
------------------
---#---------------
------------------
-----------#------
------------------
--------#---------
----------#----#--
#-----------------
---------------#--
----------#-------
------#--------#--
----#-------####--
---#--------------
------#--------#--
---#--------------
--------#---------
---------#--------
---#-----#--------
---#--------------
------------------
--#---------------
--##----#---------
------------------
--#----#------###-
--#-----------#---
----#---------###-
-----#--#---------
