#---------#---------####------
----#--------####-------------
-----#----####---#------------
----------#----------####-----
--------#-------#--------#####
----------#-------#####-------
--------#----#####-----#------
--------------#------#####----
#--#---##-#---#---#---#---#---
---#--#-#--#-----#---##--#----
------##-----#------#####----#
--##---------#--##---######-##
------#----##------######---##
--------##------#-------------
-----------##-----------#-----
-------####----##-------------
------------#------##---------
-----###--------##------------
-------------##---------------
---------#----------###-------
----##--------###-------------
-------#------###-------------
----------###------#----------
------###----#----------------
-------#-----###---#----------
---###-------#----------------
---###------##----------------
####---#----#-----------------
------------------####-------#
