###------#----------------
--#-----------------------
----#---------------------
--#--#-----------#--------
-----#--------#--#--------
-----#------#------------#
--#--------#-----#--------
--#--#------#-------------
#-------------#--#--------
---###-----------#--------
--------#---#-------#----#
-----#---------#----#-----
------#-----##-----------
-----#--------#---#-------
-----#--------#------#----
-----#----##----###-------
--#-----#----#------------
-----#------------#-------
--#---------------#-------
---##----#----------------
-----#----------#---------
----------------###-------
-------#-------##-###-----
--------#-------####------
------------#-------------
-------------###----------
