#----#----------
-----##---------
-----##----#----
----------#-----
--#-------#-----
--------###-----
-------#--#-----
----------#-----
#------###------
----#-----------
---##----#------
------#---------
----#-#---------
---#------------
-----#-------#--
-----#----------
----#-----------
-------#--------
----------#-----
