----------#----#---------
---------------#-------#-
-----#-----------------#-
-----------#---#-------##
----#--#---#---#---------
----#----#---#-----------
---------#---#-----------
---------#####-----------
#---------------#--------
-------------------------
------------#---#--------
----------------#--------
------##-------##--------
----###------------------
--------------##--#--#---
----------##------#------
---#---#--#---#----------
###----------------------
------##------------#----
----##----#-------#------
-------#-----#---#-------
------------------###----
-------------#-----##----
-------------#----#----#-
-------#---#------------#
