--------#-------------
----------#-----------
----#-----------------
----------#-----------
-------------#--------
--#----####-----------
--#--------#----------
------#---------------
#---#----#------------
--#-------------------
----#----#-------#####
###-------------------
------#--------------#
----#--------#--------
----#----#--------#---
-------#--------------
----#-------#---------
----------------------
----#------###--------
-------#--------------
----#--------#--------
