------#------------
----#-------------
--#-#-------------
-----------#------
----#-------------
----#---#---------
----------#-------
#--###--#---------
-#--#-------------
--#-------#-------
----#-------#-----
-#--#----#--#-----
----------#-------
-#---#---------#--
-#---#------------
---#----#---------
----#-#-----#-----
---###-----#------
-------#----#-----
--------##--------
