------##------------
-------#-#--#-------
---#--------#----###
---#####--------#---
----#--#----#-------
----####----#-------
----#---#---#-------
----#----------#--#-
#-----#----#---#----
------#----#---#----
---#-#----#----#----
####-----#-----#----
---#-#-----#-----#--
--#----#--#----#----
-#---#-----#----#---
--#-----#--#-#----##
--#---#---#--#----##
-------#--#--#----##
