--#---#---#-----#---
#----#------#---#---
---#----#--#----#---
--#---#----#--#-----
----##----#---#--#--
#------#--#----#--#-
---#--#-----#-------
--#-----#---#--#----
-#--#---#----#------
-#---#------#---#---
---#----#--#----#---
--#---#----#--#-----
#------#---#-----#--
---#-----#--#----#--
----#--#---#--#-----
--#----#---#----#---
---#------#--#------