#--#---#---#----#---
---#------#--#------
--#---#---#--#---#--
----#-----#--#----#-
---#---#----#----#--
#------#--#----#----
---#--#--#--#------#
--#----#------#-----
----#---#--#----#---
-#-#----#---#--#----
---#----#-----#-----
--#---#--#---#--#---
#-----#---#----#--#-
----#------#---#----
--#----#--#----#---#
---#--#---#---#-----
----#--#------#-----