----#---#-----#--#--
#------#---#----##--
---#--#---#--#------
--#---#------#---#--
----#-----#--#------
---#---#----#----#--
#------#--#----#----
#--#-#---#--#-------
--#----#------#-----
----#---#--#----#---
-#---#--#---#--#----
---#----#-----#-----
--#---#------#--#---
#--#--#---#----#---#
----#------#---#----
--#----#--#----#----
---#------#---#-----