---#----#---#----#--
#------#--#----#----
----#------#---#---#
--#----#--#----#----
---#---#--#--#------
----#-----#---#--#--
#------#--#----#----
---#-----#--#----#--
--#--#-#------#-----
----#---#--#----#---
-#--#---#---#--#----
---#----#-----#-----
--#---#------#--#---
#-----#---#----#---#
----#---#--#---#----
--#----#--#----#----
---#------#---#-----