----#--#---#---#----
--#---#--#---#---#--
#---#------#--#---#-
---#---#--#-----#---
-#------#---#--#----
---#--#------#---#--
--#----#--#---#-----
#----#-----#--#---#-
---#---#--#----#----
--#-----#---#--#----
----#--#---#-----#--
-#---#----#--#---#--
---#-----#---#--#---
--#---#------#---#--
#-----#--#----#-----
---#------#---#--#--
----#---#-----#-----