--#------#----
------#-------
#---------####
-----#--------
-#-#---------#
--------#-----
-#----#-------
#------------#
-----#----##--
--------#-----
