--#-----#-
----#-#---
#-----#--#
-----#----
--#------#
-------#--
----#-----
#-----#---
---#--#--#
---#--#---
