-----#---#--
--#----#----
----#---#---
#---#--#----
--#---#-----
----#--#----
-#---#----#-
-#----#-----
##-------##-
-------#--#-
---#----#---
---#----#---
-#---#------
