#----#----
---#------
------#--#
-#--------
-----#----
--#------#
-------#--
#----#----
----#---#-
--#-------