#-------#-
----#-----
--#----#--
------#---
-#--------
-----#--##
---#------
#------#--
----#-----
--#-------