--#----#--
-----#----
#-------#-
---#------
------#---
-#------#-
----#-----
#----#----
------#--#
--#-------