------#--#
--#-------
#----#----
----#-----
-#------#-
-------#--
---#----#-
#---------
-----#----
--#---#---