#----#----
--#------#
----#-----
-#-------#
-----#----
---#----#-
------#---
#-------#-
----#-----
-#----#---