---#----#-
#---------
-----#----
--#------#
-------#--
-#----#---
----#-----
#------#--
---#------
-----#---#