-#------#-
----#-----
#-------#-
---#------
------#---
--#----#--
-----#---#
#---------
----#----#
--#-------