----#----#
-#--------
------#---
---#----#-
#------#--
-----#----
--#------#
-------#--
#----#----
----#-----